const unsigned char lvl1_map0[16][13] = {
{ 1, 0, 4, 0, 0, 0, 0, 0, 0, 0, 0, 0, 8 },
{ 0, 0, 0, 0, 0, 0, 0, 0, 0, 0, 0, 0, 0 },
{ 4, 0, 0, 0, 0, 0, 0, 4, 3, 3, 0, 0, 0 },
{ 0, 0, 0, 0, 0, 0, 0, 10, 7, 10, 0, 9, 0 },
{ 0, 0, 0, 0, 0, 0, 0, 3, 3, 3, 0, 0, 0 },
{ 0, 0, 0, 0, 0, 8, 0, 0, 0, 0, 0, 0, 0 },
{ 5, 3, 3, 3, 3, 4, 3, 3, 3, 3, 3, 3, 3 },
{ 0, 0, 0, 0, 0, 10, 0, 0, 0, 0, 0, 0, 0 },
{ 0, 3, 3, 0, 3, 0, 3, 3, 3, 0, 3, 3, 3 },
{ 0, 3, 0, 0, 3, 0, 3, 0, 3, 0, 3, 0, 0 },
{ 0, 3, 0, 0, 3, 0, 0, 0, 3, 0, 3, 0, 0 },
{ 0, 3, 0, 0, 3, 3, 0, 0, 0, 0, 3, 0, 0 },
{ 0, 0, 3, 0, 0, 3, 0, 0, 0, 0, 3, 0, 0 },
{ 9, 9, 0, 3, 0, 4, 0, 0, 0, 0, 5, 0, 0 },
{ 3, 3, 3, 3, 3, 3, 3, 3, 0, 0, 10, 0, 0 },
{ 0, 0, 0, 0, 0, 0, 0, 0, 3, 0, 10, 0, 2 }
};

